3200000001
0101111101
0101000101
0101010001
0101011112
0001000000