2222111222
2000001312
2011101012
2021001001
2022012101
2042000002