3000000211
2121110000
1210001120
1000200000
2021111211
2000000422